12 13
3 6 2 11 6 10 10 10 3 6 10 3 
4 9 12 10 9 6 3 6 9 5 6 9 
12 3 6 10 3 5 5 5 6 9 5 7 
6 8 9 14 9 5 5 5 13 7 12 1 
5 7 6 10 10 9 5 4 11 4 10 9 
4 9 12 3 14 3 12 1 6 9 14 3 
5 6 10 9 6 1 6 9 12 10 3 4 
5 5 6 3 5 5 5 14 2 11 12 1 
5 12 9 5 5 5 12 3 5 6 10 9 
5 7 6 9 5 13 6 9 5 12 3 7 
12 1 12 3 12 2 9 6 8 11 5 5 
7 5 7 12 3 12 10 9 6 3 5 5 
12 8 8 11 12 10 10 10 9 12 8 9 
